┌─┬──┬─────────┬───┬─┬──────┬────────────────┬─────┐
│ │  │         │   │ ├──────┤                │     │
│ │  │ ┌──────┬┤   │ │      │    ┌─────────┐ │     │
│ │  │ │      ││   │ │      │    │         │ └─┬───┤
│ │  │ │      ││   │ │      │    │         │   ├───┤
│ │  │ │      ├┴───┘ └──────┘    │         │   │   │
│ │  │ └──────┘                  ├┬─────┬──┴┐  └───┤
│ │  │           ┌─────┐   ┌─────┴┤     │   │     X│
│ │  │ ┌─────────┴─────┤   │      │     │   │ ┌────┤
│ └──┘ │               │   │      │  ┌──┴───┤ │    │
│      │               │   └──────┘  │      │ │    │
│      │               │             │      │ │    │
└──────┴───────────────┴─────────────┴──────┴─┴────┘
