┌──┬───────────┬────────┬─────┬────────────────┐
│  │           │        │     │               X│
│  │           │        │     │                │
│  │           │        │     │                │
│  │           │ ┌────┐ │     │                │
│  └───────────┘ │    │ │     │                │
│                │    │ │     │    ┌───────────┤
│     ┌─────┐    │    │ │     │    │           │
│     │     │    │    │ │     │    │           │
│     │     │    │    │ │     │    │           │
│     │     │    │    │ │     │    │           │
│     │     │    │    │ │     │    │           │
│     │     │    │    │ │     │    │           │
│     │     │    │    │ │     │    └───────────┤
│     │     │    │    │ │     │                │
│     │     │    │    │ │     │     ┌──────────┤
│     │     │    │    │ └─────┘     │          │
│     │     │    │    │             │          │
│     │     │    │    │        ┌──┐ │          │
└─────┴─────┴────┴────┴────────┴──┴─┴──────────┘